-----------------------------------------------|
-                                             -|
-                                      ---    -|
---                          --              --|
-                                             -|
-     -                                   --- -|
-                      -                      -|
-                        *            ---     -|
--                    ----                    -|
-                                ---          -|
--      *         -                           -|
-      ---                   -                -|
-        -                          ---       -|
-        -                                    -|
-                                             -|
-     ----                  --                -|
-                                    -        -|
- --------    ------- ------     ------       -|
-                                             -|
-            -                               --|
--                                            -|
-                         --             --   -|
-          *                                  -|
---------------                    --         -|
-                              *              -|
-----------------------------------------------|
