-----------------------------------------------|
-                                             -|
-                                      ---    -|
---                          --              --|
-                                             -|
-     -                                   --- -|
-                      -                      -|
-                        *            ---     -|
--                    ----                    -|
-                                ---          -|
--      *         -                           -|
-      ---                   -                -|
-        -                          ---       -|
-        -                                    -|
-                                             -|
-     ----                  --                -|
-                  *                 -        -|
- --------    ------- ------     ------       -|
-                                             -|
-            -                               --|
--                                            -|
-                      -----             --   -|
-    --------                                 -|
-----                              --         -|
-                     *        *              -|
-----------------------------------------------|
