-----------------------------------------------|
-                                             -|
-                                      -      -|
---                          --              --|
-                                             -|
-     -                                   -   -|
-                      -                      -|
-                                       -     -|
--           ^        ----                    -|
-                                             -|
--                -                           -|
-      ---                   -                -|
-        -                          ---       -|
-        -          ^                         -|
-                           --                -|
-     ----                                    -|
-                                    -        -|
- --------    --^---- ------     ------       -|
-                                             -|
-            -                               --|
--                                            -|
-                         --             --   -|
-                                             -|
---------------                    --         -|
-                                             -|
-----------------------------------------------|
