-------------*-----*------------------------------------------================================================|
-                                                  --        -=                                              =|
-                                                  --------  -=                                              =|
----------*-----*-----*------**------------        --        -=                                              =|
-                                                  *-        -=                                            ===|
-                          ------                --*-        -=                                              =|
-                        --      --                *-       --=                                  ===         =|
----   ---   ---  -------          ------*         *--       -=                                              =|
-        -********-        ------        *-      --*-        -=                                              =|
-                         *      *       *         *-        -=                                              =|
-------------------------*        *--  --*         *-       --=                                              =|
-                                        *--       *-        -=          ==#==                             ===|
-                                        *         *-        -==                                             =|
-----   -----*-----*---------**----------*       --*--       -=                                         =    =|
-                                       -*-        *-        -=                            ==                =|
-                                       -*         *-        -=                                              =|
-------------------   -------------------*--       *-       --=          =#=                                 =|
-                 -                     -*         *-        -==                                             =|
-                  ------------------  --***********-        -=##############################################=|
-                                                  *--       -================================================|
-      ---     --                                  *-        -=                                              =|
-    *************-----------***--------------------         -=                                              =|
-                                                          ---=============#=====#=====#=====#=====#=====    =|
-                                                            -=                                              =|
-                                                  --        -=                                              =|
-----------------------------------------------------********-==========#=====#=====#=====#=====#=====#=======|
