--------------^-----^-------------------------------|
-                                                  -|
-                                                  -|
-----------^-----^-----^-----------------          -|
-                                                  ^|
-                          ------                --^|
-                                 -                ^|
-                                   -----^         ^|
-                                        ^-      --^|
-                                        ^         ^|
-                                        ^         ^|
-                                        ^-        ^|
-                                        ^         ^|
-                                        ^       --^|
-                                        ^--       ^|
-                                        ^       --^|
-                                        ^--       ^|
-                                        ^         ^|
-                                        ^^^^^^^^^^^|
-                                                  -|
-                                                  -|
-                                                  -|
-                                                  -|
-                                                  -|
-                                                  -|
----------------------------------------------------|
