--------------*-----*--------------------------------|
-                                                  --|
-                                                  --|
-----------*-----*-----*-----**------------        --|
-                                                  *-|
-                          ------                --*-|
-                        -        -                *-|
----   ---         -----            -----*         *-|
-       --*********-        ----         *-      --*-|
-                         *      *       *         *-|
----------------*--------*        *--  --*         *-|
-                                        *--       *-|
-                                        *         *-|
-----   -----*-----*---------**----------*       --*-|
-                                       -*--       *-|
-                                       -*       --*-|
-------------------   -------------------*--       *-|
-                 -                     -*         *-|
-                 -------------------  --***********-|
-     --                                           --|
-              --                                  --|
-    **************----------***---------------------|
-                                                  --|
-                                                  --|
-      !!!!                                        --|
-----------------------------------------------------|
