-------------*-----*------------------------------------------================================================|
-                                                  --        -=                                              =|
-                                                  --------  -=                                              =|
----------*-----*-----*------**------------        --        -=                                              =|
-                                                  *-        -=                                              =|
-                          ------                --*-        -=                                              =|
-                        --      --                *-       --=                                              =|
----   ---   ---  -------          ------*         *--       -=                                              =|
-        -********-        ------        *-      --*-        -=                                              =|
-                         *      *       *         *-        -=                                              =|
-------------------------*        *--  --*         *-       --=                                              =|
-                                        *--       *-        -=                                              =|
-                                        *         *-        -=                                              =|
-----   -----*-----*---------**----------*       --*--       -=                                              =|
-                                       -*-        *-        -=                                              =|
-                                       -*         *-        -=                                              =|
-------------------   -------------------*--       *-       --=                                              =|
-                 -                     -*         *-        -=                                              =|
-                  ------------------  --***********-        -=                                              =|
-                                                  *--       -=                                              =|
-      ---     --                                  *-        -=                                              =|
-    *************-----------***--------------------         -=                                              =|
-                                                          ---=                                              =|
-                                                            -=                                              =|
-                                                  --__      -=                                              =|
-----------------------------------------------------********-================#=========#=====================|
