--------------^-----^-------------------------------|
-                                                  -|
-                                                  -|
-----------^-----^-----^-----^^------------        -|
-                                                  ^|
-                          ------                --^|
-                        -        -                ^|
----   ---         -----            -----^         ^|
-       --^^^^^^^^^-        ----         ^-      --^|
-                         ^      ^       ^         ^|
----------------^--------^        ^--  --^         ^|
-                                        ^-        ^|
-                                        ^         ^|
-    !!!-----^-----^---------^^----------^       --^|
-                                        ^--       ^|
-                                        ^       --^|
-                                        ^--       ^|
-                                        ^         ^|
-                                        ^^^^^^^^^^^|
-                                                  -|
-                                                  -|
-                                                  -|
-                                                  -|
-                                                  -|
-                                                  -|
----------------------------------------------------|
