-------------*-----*------------------------------------------|-----------------------------------------------|
-                                                  --        -|                                              -|
-                                                  --------  -|                                              -|
----------*-----*-----*------**------------        --        -|                                              -|
-                                                  *-        -|                                              -|
-                          ------                --*-        -|                                              -|
-                        --      --                *-       --|                                              -|
----   ---   ---  -------          ------*         *--       -|                                              -|
-        -********-        ------        *-      --*-        -|                                              -|
-                         *      *       *         *-        -|                                              -|
-------------------------*        *--  --*         *-       --|                                              -|
-                                        *--       *-        -|                                              -|
-                                        *         *-        -|                                              -|
-----   -----*-----*---------**----------*       --*--       -|                                              -|
-                                       -*-        *-        -|                                              -|
-                                       -*         *-                                                        -|
-------------------   -------------------*--       *-       --|                                              -|
-                 -                     -*         *-        -|                                              -|
-                  ------------------  --***********-        -|                                              -|
-                                                  *--       -|                                              -|
-      ---     --                                  *-        -|                                              -|
-    *************-----------***--------------------         -|                                              -|
-                                                          ---|                                              -|
-                                                            -|                                              -|
-                                                  --__      -|                                              -|
-----------------------------------------------------********-------------------------------------------------|
