--------------*-----*-----------------------------------------|
-                                                  --        -|
-                                                  --------  -|
-----------*-----*-----*-----**------------        --        -|
-                                                  *-       --|
-                          ------                --*-        -|
-                        -        -                *-        -|
----   ---         -----            -----*         *--       -|
-       --*********-        ----         *-      --*-        -|
-                         *      *       *         *-        -|
----------------*--------*        *--  --*         *-       --|
-                                        *--       *-        -|
-                                        *         *-        -|
-----   -----*-----*---------**----------*       --*--       -|
-                                       -*--       *-        -|
-                                       -*       --*-        -|
-------------------   -------------------*--       *-       --|
-                 -                     -*         *-        -|
-                 -------------------  --***********-        -|
-     --                                           *--       -|
-              --                                  *-        -|
-    **************----------***---------------------        -|
-                                                          ---|
-                                                  --        -|
-                                              ****--__      -|
----------*-----*-----*------------------------------********-|
